MAP NAME : WOLF3D@42 MAP ZOMBIE
MAP WIDTH : 30
MAP HEIGHT : 30
HEIGHT MAP : FLOOR
256 256 256 256 256 256 256 256 256 256 256 256 256 256 256 256 256 256 256 256 256 256 256 256 256 256 256 256 256 256
256 156 156 156 256 256 256 256 256 256 256 256 256 256 256 256 256 256 256 256 256 256 256 256 48  256 256 256 256 256
256 156 156 156 160 160 160 160 256 204 212 220 256 244 244 244 244 244 244 256 256 74  74  74  48  74  256 256 256 256
256 156 156 156 160 160 160 160 256 196 256 228 256 244 244 244 244 244 244 256 256 82  256 74  48  74  256 256 256 256
256 156 156 156 256 256 164 256 256 188 256 236 256 244 244 244 244 244 244 256 256 90  256 74  48  74  256 256 256 256
256 156 156 156 256 164 164 164 256 180 256 244 256 256 256 256 244 256 256 256 256 98  256 74  48  74  256 256 256 256
256 156 156 156 180 164 164 164 256 172 256 244 244 244 244 244 244 244 256 256 256 106 256 74  48  74  256 256 256 256
256 156 156 156 256 164 164 164 164 164 256 256 262 256 256 256 256 256 256 256 256 114 256 74  48  74  256 256 256 256
256 156 156 156 256 256 256 256 256 256 256 160 160 160 256 256 256 162 162 256 256 122 256 74  48  74  256 256 256 256
256 156 156 156 256 256 256 162 162 162 256 160 160 160 256 256 162 162 162 162 256 130 256 74  48  74  256 256 256 256
256 156 156 156 256 256 180 162 162 162 162 160 160 160 256 256 162 256 256 154 256 138 256 74  48  74  256 256 256 256
256 156 156 156 256 256 180 162 162 162 256 160 160 160 256 256 162 256 256 146 146 146 256 74  48  74  82  82  82  256
256 156 156 156 256 256 256 162 162 162 256 256 184 256 256 256 162 256 256 256 256 256 256 74  48  48  48  48  48  256
256 156 156 156 256 256 256 256 256 162 256 162 162 162 162 162 162 162 256 256 256 256 256 74  48  74  82  82  82  256
256 156 156 156 256 256 256 162 162 162 162 162 162 162 162 162 162 162 256 256 256 256 256 74  48  74  256 256 256 256
256 156 156 156 256 256 256 162 162 162 162 162 256 162 162 256 162 162 256 256 256 256 256 74  48  74  256 256 256 256
256 156 156 156 256 256 256 162 162 162 162 162 162 162 162 162 162 162 256 256 256 256 256 74  48  74  256 256 256 256
256 156 156 156 256 256 256 162 162 162 162 162 162 162 162 162 162 162 256 256 256 256 256 74  48  74  256 256 256 256
256 156 156 156 256 256 256 256 256 256 256 256 256 256 256 256 256 256 256 256 256 256 74  74  48  74  74  256 256 256
256 156 156 156 256 256 256 256 256 256 256 256 256 256 256 256 256 256 256 256 256 74  74  48  48  48  74  74  256 256
256 156 156 156 256 256 256 256 4   256 256 256 256 256 256 256 256 256 256 256 256 74  48  48  48  48  48  74  256 256
256 156 156 156 256 256 32  32  4   32  32  256 256 256 256 256 256 256 74  74  74  74  48  48  48  48  48  74  256 256
256 156 156 156 256 256 32  32  4   32  32  256 256 256 256 256 256 256 74  74  256 74  74  48  48  48  74  74  256 256
256 156 156 156 256 256 32  32  4   32  32  98  90  82  74  256 256 256 48  256 256 256 74  74  48  74  74  256 256 256
256 156 156 156 256 256 32  32  4   4   4   4   4   48  48  48  48  48  48  256 256 256 256 256 48  256 256 256 256 256
256 156 156 156 256 256 32  32  4   32  32  98  90  82  74  256 256 256 48  256 256 256 256 256 48  256 256 256 256 256
256 156 156 156 256 256 32  32  4   32  32  256 256 256 256 256 256 256 48  48  48  48  48  48  48  256 256 256 256 256
256 156 156 156 256 256 32  32  4   32  32  256 256 256 256 256 256 256 256 256 256 256 256 256 256 256 256 256 256 256
256 156 156 156 256 256 256 256 4   256 256 256 256 256 256 256 256 256 256 256 256 256 256 256 256 256 256 256 256 256
256 256 256 256 256 256 256 256 256 256 256 256 256 256 256 256 256 256 256 256 256 256 256 256 256 256 256 256 256 256
HEIGHT MAP : CEILING
256 256 256 256 256 256 256 256 256 256 256 256 256 256 256 256 256 256 256 256 256 256 256 256 256 256 256 256 256 256
256 512 512 512 256 256 256 256 256 256 256 256 256 256 256 256 256 256 256 256 256 256 256 256 56  256 256 256 256 256
256 512 512 512 256 256 256 256 256 278 286 294 256 326 326 326 326 326 326 256 256 134 120 134 148 134 256 256 256 256
256 512 512 512 256 256 256 256 256 270 256 302 256 326 326 326 326 326 326 256 256 142 256 134 148 134 256 256 256 256
256 512 512 512 256 256 224 256 256 262 256 310 256 326 326 326 326 326 326 256 256 150 256 134 148 134 256 256 256 256
256 512 512 512 256 238 238 238 256 254 256 318 256 256 256 256 310 256 256 256 256 158 256 134 148 134 256 256 256 256
256 512 512 512 224 238 238 238 256 246 256 326 326 326 326 326 326 326 256 256 256 166 256 134 148 134 256 256 256 256
256 512 512 512 256 238 238 238 222 238 256 256 310 256 256 256 256 256 256 256 256 174 256 134 148 134 256 256 256 256
256 512 512 512 256 256 256 256 256 256 256 512 512 512 256 256 256 222 222 256 256 182 256 134 148 134 256 256 256 256
256 512 512 512 256 256 256 238 238 238 256 512 512 512 256 256 222 222 222 222 256 190 256 134 148 134 256 256 256 256
256 512 512 512 256 256 220 238 238 238 222 512 512 512 256 256 222 256 256 214 256 198 256 134 148 134 256 256 256 256
256 512 512 512 256 256 220 238 238 238 256 512 512 512 256 256 222 256 256 206 206 206 256 134 148 134 140 140 140 256
256 512 512 512 256 256 256 238 238 238 256 256 224 256 256 256 214 256 256 256 256 256 256 134 148 134 156 156 56  256
256 512 512 512 256 256 256 256 256 222 256 246 246 246 246 246 246 246 256 256 256 256 256 134 148 134 140 140 140 256
256 512 512 512 256 256 256 246 246 246 246 246 246 246 246 246 246 246 256 256 256 256 256 134 148 134 256 256 256 256
256 512 512 512 256 256 256 246 246 246 246 246 246 246 246 246 246 246 256 256 256 256 256 134 148 134 256 256 256 256
256 512 512 512 256 256 256 246 246 246 246 246 246 246 246 246 246 246 256 256 256 256 256 134 148 134 256 256 256 256
256 512 512 512 256 256 256 246 246 246 246 246 246 246 246 246 246 246 256 256 256 256 256 134 148 134 256 256 256 256
256 512 512 512 256 256 256 256 256 256 256 256 256 256 256 256 256 256 256 256 256 256 156 156 156 156 156 256 256 256
256 512 512 512 256 256 256 256 256 256 256 256 256 256 256 256 256 256 256 256 256 156 156 164 164 164 156 156 256 256
256 512 512 512 256 256 256 256 32  256 256 256 256 256 256 256 256 256 256 256 256 156 164 512 512 512 164 156 256 256
256 512 512 512 256 256 256 256 256 256 256 256 256 256 256 256 256 256 140 140 128 156 164 512 512 512 164 156 256 256
256 512 512 512 256 256 256 256 256 256 256 256 256 256 256 256 256 256 140 140 256 156 156 164 164 164 156 156 256 256
256 512 512 512 256 256 256 256 256 256 256 156 156 156 156 256 256 256 92  256 256 256 156 156 156 156 156 256 256 256
256 512 512 512 256 256 256 256 256 256 256 16  16  56  156 92  92  92  92  256 256 256 256 256 56  256 256 256 256 256
256 512 512 512 256 256 256 256 256 256 256 156 156 156 156 256 256 256 56  56  56  56  56  56  56  256 256 256 256 256
256 512 512 512 256 256 256 256 256 256 256 256 256 256 256 256 256 256 256 256 256 256 256 256 256 256 256 256 256 256
256 512 512 512 256 256 256 256 256 256 256 256 256 256 256 256 256 256 256 256 256 256 256 256 256 256 256 256 256 256
256 512 512 512 256 256 256 256 32  256 256 256 256 256 256 256 256 256 256 256 256 256 256 256 256 256 256 256 256 256
256 256 256 256 256 256 256 256 256 256 256 256 256 256 256 256 256 256 256 256 256 256 256 256 256 256 256 256 256 256

TEXTURE MAP :
0   0   0   0   0   0   0   0   0   0   0   0   0   0   0   0   0   0   0   0   4   4   4   4   6   4   4   0   0   0  
0   3   2   3   0   0   0   0   0   1   1   1   5   5   5   5   5   5   5   5   4   4   4   4   6   4   4   0   0   0  
3   3   2   3   0   0   0   0   0   1   1   1   5   5   5   5   5   5   5   5   4   4   4   4   6   4   4   0   0   0  
3   3   2   3   0   0   0   0   0   1   1   1   5   5   5   5   5   5   5   5   4   4   4   4   6   4   4   0   0   0  
0   3   2   3   0   0   0   0   0   1   1   1   5   5   5   5   5   5   5   5   4   4   4   4   6   4   4   0   0   0  
3   3   2   3   0   0   0   0   0   1   1   1   5   5   5   5   5   5   5   5   4   4   4   4   6   4   4   0   0   0  
3   3   2   3   0   0   0   0   0   1   1   1   1   1   1   1   1   1   1   0   4   4   4   4   6   4   4   0   0   0  
0   3   2   3   0   0   0   0   0   0   0   0   0   0   0   0   0   0   0   0   4   4   4   4   6   4   4   0   0   0  
3   3   2   3   0   0   0   0   0   0   0   0   0   0   0   0   0   0   0   0   4   4   4   4   6   4   4   4   4   4  
3   3   2   3   0   1   1   1   1   1   0   0   0   0   3   0   0   0   0   0   0   4   4   4   6   4   4   4   4   4  
0   3   2   3   0   1   1   1   1   1   0   0   0   0   3   0   0   0   0   0   0   0   4   4   6   4   4   4   4   4  
3   3   2   3   3   1   1   1   1   1   0   0   0   0   0   0   0   0   0   0   0   0   4   4   6   4   4   4   4   4  
3   3   2   3   3   1   1   1   1   1   0   0   0   0   0   0   0   0   0   0   0   0   4   4   6   6   6   6   6   6  
0   3   2   3   0   1   1   1   1   1   0   5   5   5   5   5   5   5   5   0   0   0   4   4   6   4   4   4   4   4  
3   3   2   3   3   5   5   5   5   5   5   5   5   5   5   5   5   5   5   0   4   4   4   4   6   4   4   4   4   4  
3   3   2   3   3   5   5   5   5   5   5   5   0   5   5   0   5   5   5   0   4   4   4   4   6   4   4   4   4   4  
0   3   2   3   0   5   5   5   5   5   5   5   5   5   5   5   5   5   5   0   4   4   4   4   6   4   4   4   4   4  
3   3   2   3   3   5   5   5   5   5   5   5   5   5   5   5   5   5   5   0   4   4   4   4   6   4   4   4   4   0  
3   3   2   3   3   5   5   5   5   5   5   5   5   5   5   5   5   5   5   0   4   4   4   4   6   4   4   4   4   0  
0   3   2   3   0   0   0   0   6   0   0   0   0   0   0   4   4   4   4   4   4   4   4   6   6   6   4   4   4   0  
3   3   2   3   3   4   4   4   6   4   4   4   4   4   4   4   4   4   4   4   4   4   6   6   6   6   6   4   4   0  
3   3   2   3   3   4   4   4   6   4   4   4   4   4   4   4   4   4   4   4   4   4   6   6   6   6   6   4   4   0  
3   3   2   3   3   4   4   4   6   4   4   4   4   4   4   4   4   4   4   4   4   4   4   6   6   6   4   4   4   0  
3   3   2   3   3   4   4   4   6   4   4   4   4   4   4   4   4   6   6   4   4   4   4   4   6   4   4   4   4   0  
3   3   2   3   3   4   4   4   6   6   6   6   6   6   6   6   6   6   6   6   4   4   4   4   6   4   4   4   4   0  
3   3   2   3   3   4   4   4   6   4   4   4   4   4   4   4   6   6   6   6   6   6   6   6   6   6   4   4   4   0  
3   3   2   3   3   4   4   4   6   4   4   4   4   4   4   4   4   4   6   6   6   6   6   6   6   6   6   4   4   0  
3   3   2   3   3   4   4   4   6   4   4   4   4   4   4   4   4   4   6   6   4   6   6   6   6   6   6   4   4   0  
3   3   2   3   3   4   4   4   6   4   4   4   4   4   4   4   4   4   4   4   4   6   6   6   6   6   6   4   4   0  
3   3   2   3   3   4   4   4   6   4   4   4   4   4   4   4   4   4   4   4   4   4   6   6   6   6   6   4   4   0  
PLAYER POSITION : Y X Z ANGLE
1 1 160 315
SPRITE LIST : Y X Z MOBILE ATTITUDE TEXTURE SIZE
23 : SPRITE NUMBER
23 6 32 1 1 44 32
25 7 32 1 1 44 32
22 9 32 1 1 44 32
6 13 244 1 1 34 32
3 17 244 1 1 44 32
12 8 162 1 1 34 32
8 17 162 1 1 34 32
8 25 74 1 1 34 32
15 24 48 1 1 34 32
6 6 164 0 0 60 32
7 2 156 0 0 54 96
3 17 244 0 0 57 0
3 15 244 0 0 61 32
10 8 162 0 0 60 32
15 11 162 0 0 56 32
15 13 162 0 0 56 32
15 14 162 0 0 56 32
15 16 162 0 0 56 32
16 7 162 0 0 55 32
15 7 162 0 0 62 32
15 25 74 0 0 59 32
25 9 192 0 0 58 32
23 6 192 0 0 58 32
