MAP NAME : WOLF3D@42 LVL: NEW YORK
MAP WIDTH : 30
MAP HEIGHT : 30
HEIGHT MAP : FLOOR
256 256 256 256 256 256 256 256 256 256 256 256 256 256 256 256 256 256 256 256 256 256 256 256 256 256 256 256 256 256
256 156 156 156 256 256 256 256 256 256 256 256 256 256 256 256 256 256 256 256 256 256 256 256 256 256 256 256 256 256
256 156 156 156 160 160 160 256 256 204 212 220 256 244 244 244 256 256 256 256 256 74  74  74  48  74  256 256 256 256
256 156 156 156 160 160 160 256 256 196 256 228 256 244 244 244 256 256 256 256 256 82  256 74  48  74  256 256 256 256
256 156 156 156 256 256 164 256 256 188 256 236 256 244 244 244 256 256 256 256 256 90  256 74  48  74  256 256 256 256
256 156 156 156 256 164 164 164 256 180 256 244 256 256 244 256 256 256 256 256 256 98  256 74  48  74  256 256 256 256
256 156 156 156 256 164 164 164 256 172 256 244 244 244 244 244 256 256 256 256 256 106 256 74  48  74  256 256 256 256
256 156 156 156 256 164 164 164 164 164 256 256 262 256 256 256 256 256 256 256 256 114 256 74  48  74  256 256 256 256
256 156 156 156 256 256 256 256 256 256 256 160 160 160 256 256 256 162 162 256 256 122 256 74  48  74  256 256 256 256
256 156 156 156 256 256 256 162 162 162 256 160 160 160 256 256 162 162 162 162 256 130 256 74  48  74  256 256 256 256
256 156 156 156 256 256 180 162 162 162 162 160 160 160 256 256 162 256 256 154 256 138 256 74  48  74  256 256 256 256
256 156 156 156 256 256 180 162 162 162 256 160 160 160 256 256 162 256 256 146 146 146 256 74  48  74  82  82  82  256
256 156 156 156 256 256 256 162 162 162 256 256 184 256 256 256 162 256 256 256 256 256 256 74  48  48  48  48  48  256
256 256 256 256 256 256 256 256 256 162 256 162 162 162 162 162 162 162 256 256 256 256 256 74  48  74  82  82  82  256
256 256 256 256 256 256 256 162 162 162 162 162 162 162 162 162 162 162 256 256 256 256 256 74  48  74  256 256 256 256
256 256 256 256 256 256 256 162 162 162 162 162 256 162 162 256 162 162 256 256 256 256 256 256 256 256 256 256 256 256
256 256 256 256 256 256 256 162 162 162 162 162 162 162 162 162 162 162 256 256 256 256 256 256 256 256 256 256 256 256
256 256 256 256 256 256 256 162 162 162 162 162 162 162 162 162 162 162 256 256 256 256 256 256 256 256 256 256 256 256
256 256 256 256 256 256 256 256 256 256 256 256 256 256 256 256 256 256 256 256 256 256 256 256 256 256 256 256 256 256
256 256 256 256 256 256 256 256 256 256 256 256 256 256 256 256 256 256 256 256 256 256 256 256 256 256 256 256 256 256
256 256 256 256 256 256 256 256 256 256 256 256 256 256 256 256 256 256 256 256 256 256 256 256 256 256 256 256 256 256
256 256 256 256 256 256 256 256 256 256 256 256 256 256 256 256 256 256 256 256 256 256 256 256 256 256 256 256 256 256
256 256 256 256 256 256 256 256 256 256 256 256 256 256 256 256 256 256 256 256 256 256 256 256 256 256 256 256 256 256
256 256 256 256 256 256 256 256 256 256 256 256 256 256 256 256 256 256 256 256 256 256 256 256 256 256 256 256 256 256
256 256 256 256 256 256 256 256 256 256 256 256 256 256 256 256 256 256 256 256 256 256 256 256 256 256 256 256 256 256
256 256 256 256 256 256 256 256 256 256 256 256 256 256 256 256 256 256 256 256 256 256 256 256 256 256 256 256 256 256
256 256 256 256 256 256 256 256 256 256 256 256 256 256 256 256 256 256 256 256 256 256 256 256 256 256 256 256 256 256
256 256 256 256 256 256 256 256 256 256 256 256 256 256 256 256 256 256 256 256 256 256 256 256 256 256 256 256 256 256
256 256 256 256 256 256 256 256 256 256 256 256 256 256 256 256 256 256 256 256 256 256 256 256 256 256 256 256 256 256
256 256 256 256 256 256 256 256 256 256 256 256 256 256 256 256 256 256 256 256 256 256 256 256 256 256 256 256 256 256
HEIGHT MAP : CEILING
256 256 256 256 256 256 256 256 256 256 256 256 256 256 256 256 256 256 256 256 256 256 256 256 256 256 256 256 256 256
256 512 512 512 256 256 256 256 256 256 256 256 256 256 256 256 256 256 256 256 256 256 256 256 256 256 256 256 256 256
256 512 512 512 256 256 256 256 256 278 286 294 256 326 326 326 256 256 256 256 256 134 134 134 140 134 256 256 256 256
256 512 512 512 256 256 256 256 256 270 256 302 256 326 326 326 256 256 256 256 256 142 256 134 140 134 256 256 256 256
256 512 512 512 256 256 224 256 256 262 256 310 256 326 326 326 256 256 256 256 256 150 256 134 140 134 256 256 256 256
256 512 512 512 256 238 238 238 256 254 256 318 256 256 326 256 256 256 256 256 256 158 256 134 140 134 256 256 256 256
256 512 512 512 256 238 238 238 256 246 256 326 326 326 326 326 256 256 256 256 256 166 256 134 140 134 256 256 256 256
256 512 512 512 256 238 238 238 238 238 256 256 310 256 256 256 256 256 256 256 256 174 256 134 140 134 256 256 256 256
256 512 512 512 256 256 256 256 256 256 256 512 512 512 256 256 256 222 222 256 256 182 256 134 140 134 256 256 256 256
256 512 512 512 256 256 256 238 238 238 256 512 512 512 256 256 222 222 222 222 256 190 256 134 140 134 256 256 256 256
256 512 512 512 256 256 220 238 238 238 238 512 512 512 256 256 222 256 256 214 256 198 256 134 140 134 256 256 256 256
256 512 512 512 256 256 220 238 238 238 256 512 512 512 256 256 222 256 256 206 206 206 256 134 140 134 140 140 140 256
256 512 512 512 256 256 256 238 238 238 256 256 224 256 256 256 222 256 256 256 256 256 256 134 140 134 134 134 108 256
256 256 256 256 256 256 256 256 256 246 256 246 246 246 246 246 246 246 256 256 256 256 256 134 140 134 140 140 140 256
256 256 256 256 256 256 256 246 246 246 246 246 246 246 246 246 246 246 256 256 256 256 256 134 134 134 256 256 256 256
256 256 256 256 256 256 256 246 246 246 246 246 246 246 246 246 246 246 256 256 256 256 256 256 256 256 256 256 256 256
256 256 256 256 256 256 256 246 246 246 246 246 246 246 246 246 246 246 256 256 256 256 256 256 256 256 256 256 256 256
256 256 256 256 256 256 256 246 246 246 246 246 246 246 246 246 246 246 256 256 256 256 256 256 256 256 256 256 256 256
256 256 256 256 256 256 256 256 256 256 256 256 256 256 256 256 256 256 256 256 256 256 256 256 256 256 256 256 256 256
256 256 256 256 256 256 256 256 256 256 256 256 256 256 256 256 256 256 256 256 256 256 256 256 256 256 256 256 256 256
256 256 256 256 256 256 256 256 256 256 256 256 256 256 256 256 256 256 256 256 256 256 256 256 256 256 256 256 256 256
256 256 256 256 256 256 256 256 256 256 256 256 256 256 256 256 256 256 256 256 256 256 256 256 256 256 256 256 256 256
256 256 256 256 256 256 256 256 256 256 256 256 256 256 256 256 256 256 256 256 256 256 256 256 256 256 256 256 256 256
256 256 256 256 256 256 256 256 256 256 256 256 256 256 256 256 256 256 256 256 256 256 256 256 256 256 256 256 256 256
256 256 256 256 256 256 256 256 256 256 256 256 256 256 256 256 256 256 256 256 256 256 256 256 256 256 256 256 256 256
256 256 256 256 256 256 256 256 256 256 256 256 256 256 256 256 256 256 256 256 256 256 256 256 256 256 256 256 256 256
256 256 256 256 256 256 256 256 256 256 256 256 256 256 256 256 256 256 256 256 256 256 256 256 256 256 256 256 256 256
256 256 256 256 256 256 256 256 256 256 256 256 256 256 256 256 256 256 256 256 256 256 256 256 256 256 256 256 256 256
256 256 256 256 256 256 256 256 256 256 256 256 256 256 256 256 256 256 256 256 256 256 256 256 256 256 256 256 256 256
256 256 256 256 256 256 256 256 256 256 256 256 256 256 256 256 256 256 256 256 256 256 256 256 256 256 256 256 256 256
//TEXTURE MAP : (NOT YET IMPLEMENTED)
PLAYER POSITION : Y X Z ANGLE
3 6 160 270
SPRITE LIST : Y X Z ALIVE MOBILE ATTITUDE TEXTURE
1 : SPRITE NUMBER
4 6 160 1 0 0 3
