MAP NAME : WOLF3D@42 ALPHA
MAP WIDTH : 15
MAP HEIGHT : 39
HEIGHT MAP : FLOOR
256 256 256 256 256 256 256 256 256 256 256 256 256 64  0
256 8   8   8   16  24  32  32  32  128 40  40  40  64  0
256 8   8   8   16  24  32  40  32  128 40  40  40  128 0
256 8   88  80  72  64  56  48  32  40  40  40  40  64  0
256 8   96  102 110 118 126 134 32  128 40  40  40  128 0
256 8   178 170 164 156 148 140 24  128 40  40  40  64  0
256 8   186 194 202 210 210 210 16  128 128 32  128 128 0
256 8   8   8   8   8   218 8   8   128 24  24  24  128 0
256 8   8   8   8   8   226 8   8   128 24  24  24  64  0
256 8   8   8   8   8   8   8   8   128 24  24  24  128 0
256 8   8   8   8   8   184 8   8   128 24  24  24  64  0
256 8   8   8   8   8   192 192 8   128 128 128 24  128 0
256 8   240 232 224 216 208 200 8   8   16  24  24  128 0
256 16  248 256 264 272 280 288 8   128 128 50  24  50  0
256 24  336 328 320 312 304 296 8   256 32  50  24  50  256
256 24  344 352 360 368 374 382 8   256 0   50  24  50  256
256 24  24  24  16  8   8   4   4   4   0   50  24  50  256
256 24  48  48  16  8   8   4   4   256 0   0   0   0   256
256 24  24  24  16  8   8   4   4   256 0   0   0   0   256
256 16  256 256 256 256 256 256 256 256 256 256 256 256 256
256 8   8   8   8   8   8   8   8   8   8   8   8   8   256
256 8   8   8   8   8   8   8   8   8   8   8   8   8   256
256 8   8   8   8   8   8   8   8   8   8   8   8   8   256
256 8   8   8   8   8   8   8   8   8   8   8   8   8   256
256 8   8   8   8   8   8   8   8   8   8   8   8   8   256
256 8   8   8   8   8   8   8   8   8   8   8   8   8   256
256 8   8   8   8   8   8   8   8   8   8   8   8   8   256
256 8   8   8   8   8   8   8   8   8   8   8   8   8   256
256 8   8   8   8   8   8   8   8   8   8   8   8   8   256
256 8   8   8   8   8   8   8   8   8   8   8   8   8   256
256 8   8   8   8   8   8   8   8   8   8   8   8   8   256
256 8   8   8   8   8   8   8   8   8   8   8   8   8   256
256 8   8   8   8   8   8   8   8   8   8   8   8   8   256
256 8   8   8   8   8   8   8   8   8   8   8   8   8   256
256 8   8   8   8   8   8   8   8   8   8   8   8   8   256
256 8   8   8   8   8   8   8   8   8   8   8   8   8   256
256 8   8   8   8   8   8   8   8   8   8   8   8   8   256
256 8   8   8   8   8   8   8   8   8   8   8   8   8   256
256 256 256 256 256 256 256 256 256 256 256 256 256 256 256
HEIGHT MAP : CEILING
256 256 256 256 256 256 256 256 256 256 256 256 256 64 256
256 512 512 512 512 512 512 512 512 128 256 256 256 120 256
256 512 512 512 512 512 512 512 512 128 256 256 256 128 256
256 512 512 512 512 512 512 512 512 128 256 256 256 120 256
256 512 512 512 512 512 512 512 512 128 256 256 256 128 256
256 512 512 512 512 512 512 512 512 128 256 256 256 120 256
256 512 512 512 512 512 512 512 512 128 128 128 128 128 256
256 512 512 512 512 512 512 8   192 128 128 128 128 128 256
256 8   8   512 512 512 512 8   192 128 128 128 128 120 256
256 192 96  512 512 512 512 128 192 128 128 128 128 128 256
256 192 8   512 512 512 512 8   192 128 128 128 128 120 256
256 192 8   512 512 512 512 512 192 128 128 128 128 128 256
256 192 512 512 512 512 512 512 192 128 128 128 128 128 256
256 192 512 512 512 512 512 512 192 128 128 50  50  50  256
256 192 512 512 512 512 512 512 192 256 128 50  50  50  256
256 192 512 512 512 512 512 512 192 256 128 50  50  50  256
256 192 192 192 192 192 192 192 192 128 128 50  50  50  256
256 192 192 192 192 192 192 192 192 256 128 128 128 128 256
256 256 256 256 256 256 256 256 256 256 256 256 256 256 256
256 256 256 256 256 256 256 256 256 256 256 256 256 256 256
256 256 256 256 256 256 256 256 256 256 256 256 256 256 256
256 256 256 256 256 256 256 256 256 256 256 256 256 256 256
256 256 256 256 256 256 256 256 256 256 256 256 256 256 256
256 256 256 256 256 256 256 256 256 256 256 256 256 256 256
256 256 256 256 256 256 256 256 256 256 256 256 256 256 256
256 256 256 256 256 256 256 256 256 256 256 256 256 256 256
256 256 256 256 256 256 256 256 256 256 256 256 256 256 256
256 256 256 256 256 256 256 256 256 256 256 256 256 256 256
256 256 256 256 256 256 256 256 256 256 256 256 256 256 256
256 256 256 256 256 256 256 256 256 256 256 256 256 256 256
256 256 256 256 256 256 256 256 256 256 256 256 256 256 256
256 256 256 256 256 256 256 256 256 256 256 256 256 256 256
256 256 256 256 256 256 256 256 256 256 256 256 256 256 256
256 256 256 256 256 256 256 256 256 256 256 256 256 256 256
256 256 256 256 256 256 256 256 256 256 256 256 256 256 256
256 256 256 256 256 256 256 256 256 256 256 256 256 256 256
256 256 256 256 256 256 256 256 256 256 256 256 256 256 256
256 256 256 256 256 256 256 256 256 256 256 256 256 256 256
256 256 256 256 256 256 256 256 256 256 256 256 256 256 256
//TEXTURE MAP : (NOT YET IMPLEMENTED)
PLAYER POSITION : Y X Z ANGLE
1 1 8 0
SPRITE LIST : Y X Z ALIVE MOBILE ATTITUDE TEXTURE
7 : SPRITE NUMBER
24 6 8 1 0 0 3
25 7 8 1 0 0 3
26 2 8 1 0 0 3
29 10 8 1 0 0 3
13 6 280 1 0 0 3
8 12 24 1 0 0 3
2 5 24 1 0 0 3
